111111111111111111
100001000000T10001
100001000000T10R01
1000P1111011111011
1CC000000000000001
1TT0P100000001P001
111111111111111111